########################################
#________________@____@________________#
#___________M_____@__@__________M______#
#__@_______________________M________@__#
#__X#______________________________#X__#
#___X#__M_________@X_@____________#X___#
#____X#__________##X_##__________#X____#
#_____X#________#_#X_#_#________#X_____#
#______X#______#__#X_#__#______#X______#
#_______X#____#___#X_#___#____#X______M#
#________X@__@____#X_#____@__@X________#
#______________________________________#
#______________________________________#
#_________@__@____#_X#____@__@_________#
#________#X___#___#_X#___#___X#_______M#
#_______#X_____#__#_X#__#_____X#_______#
#______#X_______#_#_X#_#_______X#______#
#_____#X_________##_X##_________X#_____#
#____#X___________@_X@___________X#____#
#___#X____________________________X#___#
#__@X______________________________X@__#
#_________________@__@_________________#
#__M____M_____M__@____@____M___M_______#
########################################