########################################
#______________________________________#
#_XXXX____________________________XXXX_#
#_X@@X____________________________X@@X_#
#_X@@X____________________________X@@X_#
#_XXXXX_XMXMXMX_X_X_X_X_X_XMXMXMX_XXXX_#
#____X____________________________M____#
#____M____________________________X____#
#____X____________________________M____#
#____M____________________________X____#
#____X_________________________________#
#_________________________________X____#
#____X_________________________________#
#____M____________________________X____#
#____X____________________________M____#
#____M____________________________X____#
#____X____________________________M____#
#_________________________________X____#
#_XXXX_XMXMXMX_X_X_X_X_X_XMXMXMX_XXXXX_#
#_X@@X____________________________X@@X_#
#_X@@X____________________________X@@X_#
#_XXXX____________________________XXXX_#
#______________________________________#
########################################