########################################
#@@@@@@@@@@@@@@@@@#__#@@@@@@@@@@@@@@@@@#
#@@@@@@@@@@@@@@@@@#__#@@@@@@@@@@@@@@@@@#
#@@@@@@@@@@@@@@@@@#__#@@@@@@@@@@@@@@@@@#
#@@@###############__###############@@@#
#@@@#______________________________#@@@#
#@@@#______________________________#@@@#
#@@@#______________________________#@@@#
#@@@#_____________XXXX_____________#@@@#
#@@@#______________#M______________#@@@@
#####___X#M___M#___M#______#___X___####@
#_______X_#___#____#______#M#__X_______#
#_______X__#M#______#____#___#_X_______#
#####___X___#______#M___#M___M#X___#@@##
#@@@#______________M#______________#@@@#
#@@@#_____________XXXX_____________#@@@#
#@@@#______________________________#@@@#
#@@@#______________________________#@@@#
#@@@#______________________________#@@@#
#@@@###############__###############@@@#
#@@@@@@@@@@@@@@@@@#__#@@@@@@@@@@@@@@@@@#
#@@@@@@@@@@@@@@@@@#__@@@@@@@@@@@@@@@@@@#
#@@@@@@@@@@@@@@@@@#__@@@@@@@@@@@@@@@@@@#
#################@######################