########################################
#_M________#___________________________#
#_____#M__##________________#_#______M_#
#_###_#___##________#######_____####___#
#__##_#__#________#________________#___#
#___###__#_______#_______M_________#___#
#___###__________##________________##__#
#_________#____#####_##_##_#_______##__#
#___###__##_#_#___#_________##_#______##
#___#___#_#________#___________#_______#
#_____M_#_#____#___#___________##_##___#
#______#____________#__________#_###___#
#______#__#_____M_____####_____#_#_____#
#______#__#____________####__####__##__#
#______#__#_______#______________##_##_#
#______#___#___#____________#____##____#
#____##____###__M_____________##_#_#___#
#____#_______________###_________##_#__#
#___##___________##____##________#__#__#
#_#______________#_#__#_#______MM##__#_#
#__#_____M_______###__#__#___________#_#
#________________#_____#_#____________##
#________________#_____#_#___________###
########################################