########################################
#______________________________________#
#______________________________________#
#____######X________________X######____#
#____#____________________________#____#
#____#_X######X__________X######__#____#
#____#____________________________#____#
#____#____X######X____X######_____#____#
#____#__M_______#______#_______M__#____#
#____#__________#______#__________#____#
#____________M__#______#_____M____#____#
#______________________________________#
#____#_________________________________#
#____#___M___M__#______#_____M____#____#
#____#__________#______#_______M__#____#
#____#__________#______#__________#____#
#____#____X######X____X######X____#____#
#____#____________________________#____#
#____#_X######____________######X_#____#
#____#____________________________#____#
#____######X________________X######____#
#______________________________________#
#______________________________________#
########################################