########################################
##################____##################
#################______#################
################________################
####MM_________#________#_________MM####
####MM_________####__####_________MM####
####___________#X______X#___________####
#############__#X______X#__#############
###XXXXXXXXXX__#X______X#__XXXXXXXXX_###
##_____________#X______X#_____________##
#______________#X______X#______________#
#__________________MM__________________#
#__________________MM__________________#
##_____________#X______X#______________#
###____________#X______X#_____________##
###XXXXXXXXXX__#X______X#__XXXXXXXXX_###
#############__#X______X#__#############
####___________#X______X#___________####
####MM_________####__####_________MM####
####MM_________#________#_________MM####
################________################
#################______#################
##################____##################
########################################