_________#_______######_________________
___#__####_______##__##_____#__####_____
___###_##_______###__###___####_#_#_____
___##___###____###____###___####__####__
__##_###_###_####______####__#___#####__
__#####______###________###__#_##___#___
___#_###____###___M__X___###__#_#___#___
_#___#_##__###_M__________###__#__#_____
_#_#_____####______________###_###______
############____XX__________############
###########__________X_______###########
#____________X______________M__________#
#___________________X___M______________#
###########__________________###########
############____M___________############
__________###__X____M___X__###_____#_#__
___________###____________###___##___#__
______#_____###_______X__###__##_#_#____
###_##_______###__X_____###__#_#####____
___###_#______###______###__#__###_##___
_#_##__###__X__###__M_###__#___##__###__
#_######XX_#____###__###________#_#_____
_#___#####_______##__##_##_____##_______
_#___###_________######_________________