########################################
#_##___________________#__M__#________##
#_____________M______________#________##
#_______M_________#__M_________________#
#________X____#__##_#_#__#_#___________#
#_____X_____#_#___##_##________________#
#____________##__#___##_##______X_____##
#__M________X__#_#_####________________#
#____###______###_#_#__#_____XM_______##
#____#_#_________##___##_##____________#
#____###_###__####______#______________#
#______________###_#_#_###_#__XX_X_____#
#____________#__#___#__##__##__XXX_____#
#____M_______##_____#_####_##____X_____#
#__X____X_____#___#_______###__________#
#_____________#_##_#___###_##_#________#
#______#______###_###_#__##___#________#
#________#__#____##__#_______#XXM______#
##_____M_________#_______##___X_M_____##
##____________X__##__#_#__M________X__##
#_____________X__#________M___________##
#__#____#______X_______________####___##
#__###___##____X_________####__###____##
########################################