########################################
###########X________________X###########
##########X_____M____________X##########
#########X______M_____________X#########
########X__________________M___X########
#######X________________________X#######
######X_____M__M______M__________X######
#####X____________________________X#####
####X______________________________X####
###X________________M_______________X###
##X__________M_______M____M__________X##
#______________________________________#
#___XXXXXXXXXXXXXXX__XXXXXXXXXXXXXXX___#
###################__###################
###################__###################
###################__###################
###################__###################
###################__###################
###################__###################
###################__###################
###################__###################
###################__###################
###################__###################
########################################