########################################
#@@@@@@@@@@@@@@@@@X__X@@@@@@@@@@@@@@@@@#
#@@@@@@@@@@@@@@@@@X__X@@@@@@@@@@@@@@@@@#
#@@XXXXXXXXXXXXXXXX__XXXXXXXXXXXXXXXX@@#
#@@XM_____________________________MMX@@#
#@@X_M____________________________MMX@@#
#@@X__XXXXXXXXXXXXXXXXXXXXXXXXXXXX__X@@#
#@@X__X@@@@@@@@@@@@@@@@@@@@@@@@@@X__X@@#
#@@X__X@@@@@@@@@@@@@@@@@@@@@@@@@@X__X@@#
#@@X__X@@@@@@@@@@@@@@@@@@@@@@@@@@X__X@@#
#XXX__X@@@@@@@@@@@@@@@@@@@@@@@@@@X__XXX#
#_____X@@@@@@@@@@@@@@@@@@@@@@@@@@X_____#
#_____X@@@@@@@@@@@@@@@@@@@@@@@@@@X_____#
#XXX__X@@@@@@@@@@@@@@@@@@@@@@@@@@X__XXX#
#@@X__X@@@@@@@@@@@@@@@@@@@@@@@@@@X__X@@#
#@@X__X@@@@@@@@@@@@@@@@@@@@@@@@@@X__X@@#
#@@X__X@@@@@@@@@@@@@@@@@@@@@@@@@@X__X@@#
#@@X__XXXXXXXXXXXXXXXXXXXXXXXXXXXX__X@@#
#@@XMM____________________________M_X@@#
#@@XMM_____________________________MX@@#
#@@XXXXXXXXXXXXXXXX__XXXXXXXXXXXXXXXX@@#
#@@@@@@@@@@@@@@@@@X__X@@@@@@@@@@@@@@@@@#
#@@@@@@@@@@@@@@@@@X__X@@@@@@@@@@@@@@@@@#
########################################