########################################
#______________________________________#
#______________________________________#
#______________________________________#
#______________________________________#
#______________________________________#
#______________________________________#
#______________________________________#
#______________________________________#
#______________________________________#
#______________________________________#
#__________________LL__________________#
#__________________LL__________________#
#______________________________________#
#______________________________________#
#______________________________________#
#______________________________________#
#______________________________________#
#______________________________________#
#______________________________________#
#______________________________________#
#______________________________________#
#______________________________________#
########################################