########################################
#@@@@@@@@@@@@@@@@@@__@@@@@@@@@@@@@@@@@@#
#@@@@@@@@@@@@@@@@X____X@@@@@@@@@@@@@@@@#
#@@@@@@@@@@@@@@@X______X@@@@@@@@@@@@@@@#
#@@@@@@@@@@@@@@X________X@@@@@@@@@@@@@@#
#@@@@@@@@@@@@@X__________X@@@@@@@@@@@@@#
#@@@@X____________________________X@@@@#
#@@@X______________________________X@@@#
#@@X________________________________X@@#
#@X__________________________________X@#
#@____________________________________@#
#______________________________________#
#______________________________________#
#@____________________________________@#
#@X__________________________________X@#
#@@X________________________________X@@#
#@@@X______________________________X@@@#
#@@@@X____________________________X@@@@#
#@@@@@@@@@@@@@X__________X@@@@@@@@@@@@@#
#@@@@@@@@@@@@@@X________X@@@@@@@@@@@@@@#
#@@@@@@@@@@@@@@@X______X@@@@@@@@@@@@@@@#
#@@@@@@@@@@@@@@@@X____X@@@@@@@@@@@@@@@@#
#@@@@@@@@@@@@@@@@@@__@@@@@@@@@@@@@@@@@@#
########################################